11 14
WWWWWWWWWWWWWFWWWWWWWWW
WWRRRRRRRRRRRRRRWWWWWWW
WWRWWWWWWWWWWWWRWWWRRWW
WWRWWRDRWWWWWWWRWWWWRWW
WWRRQRWRWRRRRRRRRRWWRWW
WWRWWWWRWWWWWWWRWWWWRWW
WWRWRMRRWWWRWWWRWWWWRWW
WRRWWWWRWWWRWWWRRRRRRWW
WRWWWWWRWWWRWWWDWWWWRRW
WRWRWWWRRRRRRRRRRWRWWRW
WQWRWWWWWRWRWWWRWWRWWRW
WRWRRRRWWRWRWWWRWWRDRRW
WRWRWWRWWRWRRQRRRRRWRWW
WRWRWWRWWRWRWWWWRWWWRWW
WRRRWWRRRRWRWWWWRRRRRWW
WWWWWWWWWWWWWWWWWWWWWWW