18 14
WWWWWWWFWWWWWWWWWWWWWWW
WRRRRRRRRRRRWWRRRRWWWWW
WWWWRWWWWWWWWWWRWWWWWWW
WWWWRRRRRMRRRRRRWWWQWWW
WWWWRWWWWWWWWWWRWWWRWWW
WWRRRRRWWWWQWWWRWRRRRRW
WWWWWWRWWWWRWWWRWRWWWRW
WWMWWWRRRRRRRRRRWRWQWRW
WWRWWWWWRWWWWWWWWRDRWRW
WWRRRRRDRWWWWWWWWRWRWRW
WWWWWWWWRRRRRRRRWRWRRRW
WWRRRRRRRWWDWWWRWRWWRWW
WWRWWDWWRWRRRQWRRRWWRWW
WWRWWRWWWWRWWWWRWWRRRWW
WWRRRRRWWWRRRRRRWWRWWWW
WWWWWWWWWWWWWWWWWWWWWWW