11 14
WWWWWWWWWWWWWFWWWWWWWWW
WWRRRRRRRRRRRRRRWWWWWWW
WWDWWWWWWWWWWWWDWWWRRWW
WWRWRRDRWWWWWWWRWWWWRWW
WWRRRWWRWRRRRRRRRRWWRWW
WWRWWCWRWWWWWWWRWWWWRWW
WWRWRRMRWWWRWWWRWWWWRWW
WRRWWWWRWWWRWWWRRRRRRWW
WRWWWWQRWWWRWWWDWWWWRRW
WRWRWWWRRRRRRRRRRWRWWRW
QRWRWWWWWRWRWWWRWWRWWRW
WRWRRRRWWRWRWWWRWWRDRRW
WRWRWWRWWRWRRRRRRRRWRWW
WRWRWWRWWRWCWQWWRWWWRWW
WRRRWWRRRRQRDWWWRRRRRWW
WWWWWWWWWWWMWWWWWWWWWWW