19 14
WWWWWWWFWWWWWWWWWWWWWW
WRRRRRRRRRRRWWRRRRWWWW
WWWWRWWWWWWWWWWRWWWWWW
WWWWRRRRRMRRRRRRWWWQWW
WWWWRWWWWWWWWWWRWWWRWW
WWRRRRRWWWWQWWWRWRRRRR
WWRWWWRWWWWRWWWRWRWWWR
WWMWWWRRRRRRRRRRWRWQWR
WWRWWWWWRWWWWWWWWRDRWR
WWRRRRRDRWWWWWWWWRWRWR
WWWWWWWWRRRRRRRRWRWRRR
WWRRRRRRRWWDWWWRWRWWRW
WWRWWDWWRWRRRQWRRRWWRW
WWRWWRWWWWRWWWWRWWRRRW
WWRRRRRWWWRRRRRRWWRWWW
WWWWWWWWWWWWWWWWWWWWWW