WWWWWWWWWWWWWRWWWWWWWWW
WWRRRRRRRRRRRRRRWWWWWWW
WWRWWWWWWWWWWWWRWWWRRWW
WWRWWRWRWWWWWWWRWWWWRWW
WWRRRRWRWRRRRRRRRRWWRWW
WWRWWWWRWWWWWWWRWWWWRWW
WWRWRRRRWWWRWWWRWWWWRWW
WRRWWWWRWWWRWWWRRRRRRWW
WRWWWWWRWWWRWWWWWWWWRRW
WRWRWWWRRRRRRRRRRWRWWRW
WRWRWWWWWRWRWWWRWWRWWRW
WRWRRRRWWRWRWWWRWWRWRRW
WRWRWWRWWRWRRRRRRRRWRWW
WRWRWWRWWRWRWWWWRWWWRWW
WRRRWWRRRRWRWWWWRRRRRWW
WWWWWWWWWWWWWWWWWWWWWWW